1111111111111111
1P0110C11C0000C1
1001100110000001
10C11C0111111C01
1000000000000001
1C000000000000C1
111110C110011111
11111001100000A1
11111C011C0000E1
1111111111111111