11111111111111111111
1111C111C111C1111001
11C101C101C101C11001
1PE000000000000000A1
11101C101C101C101001
111C111C111C111C1001
11111111111111111111