1111111111111
1001A000000C1
1000011111001
1P0011E0000A1
1111111111111