1111111111111
10010000001A1
1000011000011
1P0C11E001001
1111111111111